#.##2#....*
#..#.#.#..#.
#..%.###.*#.
.......#..#.
#..*...#..#.
###....%..#.
.....#....#.
.##....**@#
.#%##.####..
.#.....##...
.#..####.......
.......
......