MMMMMMMMMMMMM
........2....
........#....
.......#.**..
.##...#....
....#.......
...........@.
.....#.