MMMMMMMMMMMMM
.@...........
.###.........
.............
.###.....#
.###....#..##
...........2.
....########.
