.@...........
.###.........
.............
.........####
.............
.###....#####
.............
....########.
