MMMMMMMMMMMMM
............
......###....
..2..........
.###.....#
.#*#....#..##
...........@.
....########.