MMMMMMMMMMMMM
.@...........
.###.....**..
.............
..**.....####
.###....#####
..........2..
..*.########.
