MMMMMMMMMMMMM
.@...........
.###.........
.......**....
.###.....#
.###....#..##
...........2.
....########.
