MMMMMMMMMMMMM
........P....
......###....
.............
.###.....#
.###....#..##
...........@.
....########.