MMMMMMMMMMMMM
........P....
......###....
.............
.###.....#
.***....#..##
...........@.
..#.########.