MMMMMMMMMMMMM
........2....
.....*###....
..**.#.****..
.###......
.###....##.##
...i.e.....@#
....#########