MMMMMMMMMMMMM
...**...2#...
##########..#
.......#.**##
........#..
####....#####
*.e..#.....@.
#############