MMMMMMMMMMMMM
........2....
......HHH....
..D......F...
.HHH.....H
.***....H..HH
...........@.
..H.HHHHHHHH.