MMMMMMMMMMMMM
..*.........
......###....
..2.........*
.###.....#
.#*.....#..##
...........@.
..#.########.