MMMMMMMMMMMMM
..........2..
.........55.
.....*.5.**..
.555....55..
..........5.
...@.......5.
5555555555555