MMMMMMMMMMMMM
.@...........
.888.........
.*8....**2...
.88......8..*
..888....8..8
.......8.....
....888888888