MMMMMMMMMMMMM
........2....
.....*###....
..**.#.****..
.###......
.###....##.##
...........@#
....#########