MMMMMMMMMMMMM
........P....
......###....
i.e.i........
.###.....#
.***....#..##
...i..e....@i
..#.########.