MMMMMMMMMMMMM
.@...........
.888.........
.*8....**....
.88......8..*
..888....82.8
.......8.....
....888888888