MMMMMMMMMMMMM
.@...........
.###.........
.*#....**....
..#......#
.###....#..##
...i.e.....2i
....########.
