MMMMMMMMMMMMM
.@...........
.###.........
.*#....**....
.##......#
.###....#..##
...........2.
....########.
