MMMMMMMMMMMMM
.@...........
.###.....**..
........i..e.
ie**i....####
.###....#####
...i..e...2.i
..*.########.
