MMMMMMMMMMMMM
........2....
......###....
..*********..
.###.....#
.###....#..##
...........@.
....########.