MMMMMMMMMMMMM
.@...........
.888.........
.*8....**2...
..8......8..*
.8888....8..8
.......8..e..
....888888888